1111111111111111111111111111111111111114
1000000000000000000000000000000000000004
1000000000000000000000000000000000000004
1000000000000000000000000000000000000004
1000000000000000000000000000000000000004
1000000000000000000000000000000000000004
1000000000000000000000000000000000000004
1000000000000000000000000000000000000004
1000000000002000000000000000000000000004
1000000000000000000000000000000000000004
1000000000000000000000000000000000000004
1000000000000000000000000000000000000004
1000000000000000000000000000000000000004
1000000000000000000000000000000000000004
1000000000000000000000000000000000000004
1000000000000000000000000000000000000004
1000000000000000000000000000000000000004
1000000000000000000000000000000000000004
1000000000000000000000000000000000000004
13456789ABCDEFGHIJKLMNOPQRSTUVWXYZ!@#$%^
