11111111111111111111111111111111111111111111111111111111111111111111111111111111111111111111111114
10000000000000000000000000000000000000000000000000000000000000000000000000000000000000000000000004
10000000000000000000000000000000000000000000000000000000000000000000000000000000000000000000000004
10000000000000000000000000000000000000000000000000000000000000000000000000000000000000000000000004
10000000000000000000000000000000000000000000000000000000000000000000000000000000000000000000000004
10000000000000000000000000000000000000000000000000000000000000000000000000000000000000000000000004
10000000000000000000000000000000000000000000000000000000000000000000000000000000000000000000000004
10000000000000000000000000000000000000000000000000000000000000000000000000000000000000000000000004
10000000000000000000000000000000000000000000000000000000000000000000000000000000000000000000000004
10000000000000000000000000000000000000000000000000000000000000000000000000000000000000000000000004
10000000000000000000000000000000000000000000000000000000000000000000000000000000000000000000000004
10000000000000000000000000000000000000000000000000000000000000000000000000000000000000000000000004
10000000000000000000000000000000000000000000000000000000000000000000000000000000000000000000000004
10000000000000000000000000000000000000000000000000000000000000000000000000000000000000000000000004
10000000000000000000000000000000000000000000000000000000000000000000000000000000000000000000000004
10000000000000000000000000000000000000000000000000000000000000000000000000000000000000000000000004
10000000000000000000000000000000000000000000000000000000000000000000000000000000000000000000000004
10000000000000000000000000000000000000000000000000000000000000000000000000000000000000000000000004
10000000000000000000000000000000000000000000000000000000000000000000000000000000000000000000000004
10000000000000000000000000000000000000000000000000000000000000000000000000000000000000000000000004
10000000000000000000000000000000000000000000000000000000000000000000000000000000000000000000000004
10000000000000000000000000000000000000000000000000000000000000000000000000000000000000000000000004
10000000000000000000000000000000000000000000000000000000000000000000000000000000000000000000000004
10000000000000000000000000000000000000000000000000000000000000000000000000000000000000000000000004
10000000000000000000000000000000000000000000000000000000000000000000000000000000000000000000000004
10000000000000000000000000000000000000000000000000000000000000000000000000000000000000000000000004
10000000000000000000000000000000000000000000000000000000000000000000000000000000000000000000000004
10000000000000000000000000000000000000000000000000000000000000000000000000000000000000000000000004
10000000000000000000000000000000000000000000000000000000000000000000000000000000000000000000000004
10000000000000000000000000000000000000000000000000000000000000000000000000000000000000000000000004
10000000000000000000000000000000000000000000000020000000000000000000000000000000000000000000000004
10000000000000000000000000000000000000000000000000000000000000000000000000000000000000000000000004
10000000000000000000000000000000000000000000000000000000000000000000000000000000000000000000000004
10000000000000000000000000000000000000000000000000000000000000000000000000000000000000000000000004
10000000000000000000000000000000000000000000000000000000000000000000000000000000000000000000000004
10000000000000000000000000000000000000000000000000000000000000000000000000000000000000000000000004
10000000000000000000000000000000000000000000000000000000000000000000000000000000000000000000000004
10000000000000000000000000000000000000000000000000000000000000000000000000000000000000000000000004
10000000000000000000000000000000000000000000000000000000000000000000000000000000000000000000000004
10000000000000000000000000000000000000000000000000000000000000000000000000000000000000000000000004
10000000000000000000000000000000000000000000000000000000000000000000000000000000000000000000000004
10000000000000000000000000000000000000000000000000000000000000000000000000000000000000000000000004
10000000000000000000000000000000000000000000000000000000000000000000000000000000000000000000000004
10000000000000000000000000000000000000000000000000000000000000000000000000000000000000000000000004
10000000000000000000000000000000000000000000000000000000000000000000000000000000000000000000000004
10000000000000000000000000000000000000000000000000000000000000000000000000000000000000000000000004
10000000000000000000000000000000000000000000000000000000000000000000000000000000000000000000000004
10000000000000000000000000000000000000000000000000000000000000000000000000000000000000000000000004
10000000000000000000000000000000000000000000000000000000000000000000000000000000000000000000000004
10000000000000000000000000000000000000000000000000000000000000000000000000000000000000000000000004
10000000000000000000000000000000000000000000000000000000000000000000000000000000000000000000000004
10000000000000000000000000000000000000000000000000000000000000000000000000000000000000000000000004
10000000000000000000000000000000000000000000000000000000000000000000000000000000000000000000000004
10000000000000000000000000000000000000000000000000000000000000000000000000000000000000000000000004
10000000000000000000000000000000000000000000000000000000000000000000000000000000000000000000000004
10000000000000000000000000000000000000000000000000000000000000000000000000000000000000000000000004
10000000000000000000000000000000000000000000000000000000000000000000000000000000000000000000000004
11111111111000000000000000011111111111111111111111111111111111111111111111111111111111111111111111
          100000000000000001         
          100000000000000001
          100000000000000001
          100000000000000001
          100000000000000001
          100000000000000001
          100000000000000001
          100000000000000001
          100000000000000001
          100000000000000001
          100000000000000001
          111111111111111111
